0,0,0,0,0,0,0,0,0,0,0,0,0,1,1,
0,0,0,0,0,0,1,1,1,1,1,1,1,1,1,
0,0,0,0,0,0,0,0,0,1,0,0,0,1,1,
0,0,0,0,0,0,0,0,0,6,0,0,0,1,1,
0,0,0,0,0,0,0,0,0,6,0,0,0,1,1,
0,0,0,0,0,0,0,0,0,6,0,0,0,1,1,
0,0,0,0,0,0,0,0,0,1,0,0,0,1,1,
0,0,0,0,0,0,0,0,0,1,0,0,0,1,1,
0,0,0,0,0,0,0,0,32,54,0,0,0,1,1,
0,0,0,0,0,0,0,0,33,55,0,0,0,1,1,
0,0,0,0,0,0,0,0,34,56,0,0,0,1,1,
0,0,0,0,0,0,0,0,0,0,0,0,0,1,1,
0,0,0,0,0,0,1,1,1,1,1,1,1,1,1,
0,0,0,0,0,0,0,0,0,0,0,0,0,1,1,
0,0,0,0,0,0,0,0,0,0,0,0,0,1,1,
0,0,0,0,0,0,0,0,0,0,0,0,0,1,1,
0,0,0,0,0,0,0,0,0,0,0,0,0,0,0,
0,0,0,0,0,0,0,0,0,0,0,0,0,0,0